11
11
xxxxxxxxxxx
x..**.**..x
x.x*x.x*x.x
x*...*...*x
x*x.x*x.x*x
x.*.***.*.x
x*x*x*x.x*x
x*..***..*x
x.x*x.x*x.x
x..**.**..x
xxxxxxxxxxx